S                                                                                                                                                                    XX
S      F                                                                                                                                                             XX
S                                                                                                                                                                    XX
S                                                                                                                                                                    XX
SA      AA    A     AA      AA        AA        A    A      AA    A     AA       A     AA       A      AA      A      AA   A     AA        A          AA       A     XX
------------------------------------------------------------------------------NOT LOADED-----------------------------------------------------------------------------XX