S                                                                          X
S                                                                          X
SA                                                A                    A   X
SAA            AA        A              A                                  X
S       AA    A           A      A     A                                   X
----------------------------------------------------------------------------