S                                                                                                  X
S                                                                                                  X
S                                                                                                  X
S                                                                                                  X
SAA     AA       AA      AA          AA        AA          A    A         A     A             A    X
----------------------------------------------------------------------------------------------------